NO ./texture/test/north_texture.png
SO ./texture/test/south_texture.png
WE ./texture/test/west_texture.png
EA ./texture/test/east_texture.png

F 220,100,0
C 225,30,0

11111111
10000001
1100W001
10000001
11100001
10000001
11111101
11111111
