NO ./texture/test/north_texture.png
SO ./texture/test/south_texture.png
WE ./texture/test/west_texture.png
EA ./texture/test/east_texture.png

F 220,100,0
C 225,30,0

1111111111111111111111111
1000000000110000000000001
1011000001110000000000001
1001000000000000W0000000111111111
111111111011000001110000000000001
100000000011000001110111111111111
11110111111111011100000010001
11110111111111011101010010001
11000000110101011100000010001
10000000000000001100000010001
11111111111111111111111111111
