NO ./texture/test/north_texture.png
WE ./texture/test/west_texture.png
EA ./texture/test/east_texture.png
SO ./texture/test/south_texture.png

C 225,30,0
F 220,200,0



111111111111111111111111111111111111
110000000001100000000000000000000011
100000000001100000000000000000000001
100000000000000000000000000000000001
100111101101100111111000011111000001
100011101101100000001101100111000001
100001101101101111001100110011000001
100001101101101100011100011011000001
100000111111000111111000001110000001
100000000000000000000000000000000001
100011110111100011111000111110110001
100110011100110110001101110000110001
100110000000110100001100111000110001
100110110000110000001101110000110001
100011100001100000001100011111100001
100000000000000000000000000000000001
100000000000111111111110000000000001
100000000000011111111100000000000001
100000000000001111111000000000000001
10000000000000011E110000000000000001
100000000000000000000000000000000001
100000000000000111110000000000000001
111111111111111111111111111111111111